11
51
115 115 115 115 115 115 115 115 115 115 115 115 115 115 115 115 115 115 115 115 115 44 115 115 115 115 115 115 115 115 115 115 115 115 115 115 115 115 115 115 115 115 115 115 115 115 115 115 115 115 115
115 115 115 115 115 115 115 115 115 115 115 115 115 115 115 115 115 115 115 115 115 44 115 115 115 115 115 115 115 115 115 115 115 115 115 115 115 115 115 115 115 115 115 115 115 115 115 115 115 115 115
115 115 115 115 115 115 115 115 115 115 115 115 115 115 115 115 115 115 115 115 115 44 115 115 115 115 115 115 115 115 115 115 115 115 115 115 115 115 115 115 115 115 115 115 115 115 115 115 115 115 115
115 115 115 115 115 115 115 115 115 115 115 115 115 115 46 55 55 48 115 115 115 44 55 55 55 115 115 115 115 115 115 115 115 115 115 115 115 115 115 115 115 115 115 115 115 115 46 48 115 115 115
115 115 115 115 115 115 115 115 115 115 115 115 115 115 115 115 115 115 115 115 115 44 115 115 115 55 49 115 115 115 111 115 115 115 115 115 115 115 115 115 115 115 115 115 115 115 115 115 115 115 115
115 115 115 115 115 115 115 115 115 46 55 55 48 115 115 115 115 115 115 47 55 44 115 115 115 115 115 115 115 46 55 48 115 115 115 115 115 115 46 48 115 55 55 55 115 115 115 115 115 47 55
115 115 115 115 115 115 115 115 115 115 115 115 115 115 115 115 55 115 115 115 115 44 115 115 115 115 115 115 115 115 115 115 115 115 115 115 115 115 115 115 115 44 44 44 115 115 115 115 115 115 115
115 115 115 115 115 115 55 55 115 115 115 115 115 115 115 115 44 115 115 115 115 115 115 115 115 46 55 48 115 115 115 115 115 115 46 48 115 115 115 115 115 44 44 44 115 115 115 115 115 115 115
115 115 115 115 115 115 44 44 115 115 115 115 115 115 115 115 44 115 115 115 115 115 115 55 115 115 115 115 115 115 115 115 115 115 115 115 115 115 115 115 115 44 44 44 115 115 115 115 115 115 115
55 55 55 55 55 55 44 44 115 115 115 115 115 115 115 115 44 55 55 55 55 55 55 44 115 115 115 115 115 115 115 115 115 115 115 115 115 115 115 115 115 44 44 44 115 115 115 115 115 115 115
44 44 44 44 44 44 44 44 115 115 115 115 115 115 115 115 44 44 44 44 44 44 44 44 115 115 115 115 115 115 115 115 115 115 115 115 115 115 115 115 115 44 44 44 115 115 115 115 115 115 115
